###########
######1112#
######0##2#
######0##2#
1111110##2#
#########2#
#########2#
#########2#